7 2 2 2 2 2 2 2 2 2 2 2 2 2 8 7 2 2 2 8 7 2 2 2 8 7 2 2 2 8
3 0 0 0 0 0 0 0 0 0 0 0 0 0 14 13 0 0 0 4 3 0 0 0 14 13 0 0 0 4 
3 0 0 0 0 0 0 0 0 0 0 0 0 0 0 0 0 0 0 4 3 0 0 0 0 0 0 0 0 4
3 0 0 0 0 0 0 0 0 0 0 0 0 0 12 11 0 0 0 4 3 0 0 0 12 11 0 0 0 4
5 11 0 12 1 1 1 1 1 1 1 1 1 1 6 5 1 1 1 6 3 0 0 0 4 3 0 0 0 4
7 13 0 14 8 7 2 2 2 2 2 2 2 2 2 2 2 2 2 8 3 0 0 0 4 3 0 0 0 4
3 0 0 0 14 13 0 0 0 0 0 0 0 0 0 0 0 0 0 4 3 0 0 0 4 3 0 0 0 4
3 0 0 0 0 0 0 0 0 0 0 0 0 0 0 0 0 0 0 4 3 0 0 0 4 3 0 0 0 4
3 0 0 0 12 11 0 0 0 0 0 0 0 0 0 0 0 0 0 4 3 0 0 0 4 3 0 0 0 4
5 1 1 1 6 5 1 1 1 1 1 1 1 1 1 1 11 0 12 6 3 0 0 0 4 3 0 0 0 4
7 2 2 2 2 2 2 2 2 2 2 2 2 2 2 2 13 0 14 8 3 0 0 0 4 3 0 0 0 4
3 0 0 0 0 0 0 0 0 0 0 0 0 0 0 0 0 0 0 14 13 0 0 0 4 3 0 0 0 4
3 0 0 0 0 0 0 0 0 0 0 0 0 0 0 0 0 0 0 0 0 0 0 0 4 3 0 0 0 4
3 0 0 0 0 0 0 0 0 0 0 0 0 0 0 0 0 0 0 12 11 0 0 0 4 3 0 0 0 4
5 11 0 0 12 1 1 1 1 1 1 1 1 1 1 1 1 1 1 6 3 0 0 0 4 3 0 0 0 4
7 13 0 0 14 2 2 2 2 2 2 2 2 2 2 2 2 2 2 8 3 0 0 0 4 3 0 0 0 4
3 0 0 0 0 0 0 0 0 0 0 0 0 0 0 0 0 0 0 4 3 0 0 0 4 3 0 0 0 4
3 0 0 0 0 0 0 0 0 0 0 0 0 0 0 0 0 0 0 4 3 0 0 0 4 3 0 0 0 4
3 0 0 0 0 0 0 0 0 0 0 0 0 0 0 0 0 0 0 4 3 0 0 0 4 3 0 0 0 4
5 1 1 1 1 1 1 1 1 1 1 1 1 1 1 1 1 1 1 6 5 1 1 1 6 5 1 1 1 6